2 5 3718 3723 2511 3732 3721 
3 3 1804 2418 3685 
3 3 4 2667 3664 
3 3 3685 927 1304 
1 3 1304 3670 4 
1 3 4 3670 1304 
1 2 1804 3718 
2 4 3708 3710 3714 1804 
2 9 2516 2570 3644 3653 1836 3678 3693 2367 3708 
1 6 2516 2309 3631 3640 1666 1304 
1 28 3708 3715 2125 2149 3739 3738 495 2376 1068 1768 113 3790 3800 1080 3804 1085 1848 2142 2342 2574 1611 1081 2492 392 3874 1906 3869 2005 
1 17 2812 2379 2066 1609 2708 567 1384 497 3854 1566 141 1414 2506 855 1541 2547 3834 
1 27 3834 3828 1933 3820 1237 2156 1236 647 718 1195 201 1943 801 3796 2354 896 2028 1106 547 3720 394 2361 3712 2720 3700 1668 3703 
1 28 3703 1833 2400 1209 2363 3643 1578 188 1869 267 1145 3592 3581 1203 3564 670 963 2035 2793 18 2012 2828 3411 1274 3401 3395 3377 3367 
1 30 3708 2367 2575 3679 2437 154 890 1409 3632 1378 3612 2110 357 690 1114 127 3573 396 794 1251 1390 3530 3516 1480 2706 3480 2273 3474 3476 3481 
1 25 3481 2231 3489 3483 432 3463 3458 1660 2199 1691 2078 3394 759 1399 3368 1889 1101 3333 63 3343 1590 3326 2285 2182 3320 
1 22 3481 3476 3474 1161 1056 3469 3472 997 2399 743 1961 104 2173 2322 1879 297 2283 3443 2519 2884 3423 1979 
1 11 1979 753 2767 3449 804 3478 1948 1928 330 2836 2612 
1 12 1979 3406 2260 977 1477 1732 498 3286 2195 2366 2668 2579 
1 19 3708 3715 2784 3725 3735 2814 3747 2729 1485 3769 2544 3774 2388 2854 678 661 515 219 3795 
1 17 2579 641 3233 2532 3215 848 3214 1819 2448 277 3204 470 3196 1347 2491 3164 2636 
1 11 2636 1046 892 1846 587 3014 2413 2415 2998 2997 2994 
1 22 2636 974 1330 1188 421 1451 1715 2602 3015 1003 2968 2288 800 2038 941 489 1877 2920 2915 2913 2909 1701 
1 36 2612 3526 2281 3513 327 3529 3534 417 55 911 1484 805 1810 920 3554 3550 340 225 3563 1685 1381 2436 2181 2494 3527 2209 536 3543 2026 240 1435 841 3446 1825 3415 1274 
1 11 2828 1532 1517 2233 69 3405 1557 1369 2080 99 3416 
1 3 18 3441 1825 
1 7 1765 825 3604 398 1932 14 1810 
